.....................@@...
.....................@@...
....................@@....
............@@......@@....
............%%....###.....
..........##%%##..###.....
..........%%%%%%..###.....
........@@%%%%%%@@###.....
........%%%%--%%%%###.....
......##%%%%--%%%%###.....
......%%%%------%%%%#.....
....@@%%%%------%%%%#.....
....%%%%----------%%%%....
..##%%%%----------%%%%##..
..%%%%-----@--------%%%%..
@@%%%%--------------%%%%@@
%%%%--------@---------%%%%
%%%%------------------%%%%
..%%----------@-------%%..
..%%------------------%%..
..%%-----------@------%%..
..%%---.............--%%..
..%%---.............--%%..
..%%---....####.....--%%..
..%%---....#..#.....--%%..
..%%---....#..#.....--%%..